16
72
140 140 140 140 140 140 140 140 140 140 140 140 140 140 140 140 
140 0 0 0 0 0 0 0 0 0 0 0 0 0 0 140 
140 122 0 0 0 0 0 0 0 0 0 0 0 0 0 140 
140 141 141 141 141 141 141 141 141 141 141 141 141 0 0 140 
140 0 0 0 0 0 0 0 0 0 0 0 0 0 0 140 
140 0 0 0 0 0 0 0 0 0 0 0 0 0 0 140 
140 0 0 0 141 141 141 141 141 141 141 141 141 141 141 140 
140 0 0 0 0 0 0 0 0 0 0 0 0 0 0 140 
140 140 0 0 0 0 0 0 0 0 0 0 0 0 0 140 
140 0 0 0 0 0 0 0 140 0 0 0 0 0 0 140 
140 0 0 140 0 0 0 0 0 140 0 0 0 0 0 140 
140 0 0 0 0 0 0 0 0 0 140 0 0 0 0 140 
140 0 0 0 0 0 0 0 0 0 0 140 0 0 0 140 
140 0 0 0 140 0 0 0 0 0 0 140 0 0 0 140 
140 0 0 0 0 0 0 0 0 0 0 140 140 140 140 140 
140 0 0 0 0 0 0 140 0 0 0 0 0 0 0 140 
140 0 140 0 140 0 0 0 0 0 0 0 0 0 0 140 
140 0 140 0 0 0 0 0 0 0 140 140 140 0 0 140 
140 0 140 0 0 0 0 0 140 0 0 0 0 0 0 140 
140 0 140 0 0 0 0 140 0 0 0 0 0 0 0 140 
140 140 140 140 140 0 0 0 0 0 0 0 0 0 0 140 
140 0 0 0 0 0 0 0 0 0 0 0 0 0 0 140 
140 0 0 0 0 0 0 0 0 0 0 0 0 0 0 140 
140 140 140 140 0 0 140 0 0 140 0 140 140 140 140 140 
140 0 0 0 0 0 0 0 0 0 0 0 0 0 0 140 
140 0 0 0 0 0 0 0 0 0 0 0 0 0 0 140 
140 0 0 0 0 0 140 140 140 140 0 0 0 0 0 140 
140 0 0 0 0 0 140 140 140 140 0 0 0 0 0 140 
140 0 0 0 0 0 0 0 0 0 0 0 0 0 0 140 
140 0 0 0 0 140 0 0 0 0 140 0 0 0 0 140 
140 0 0 0 0 0 0 0 0 0 0 0 0 0 0 140 
140 0 140 0 0 0 0 0 0 0 0 0 0 140 0 140 
140 0 0 0 0 0 0 0 0 0 0 0 0 0 0 140 
140 0 0 0 140 0 0 0 0 0 0 140 0 0 0 140 
140 0 0 0 0 0 0 0 0 0 0 0 0 0 0 140 
140 0 0 0 0 0 0 140 140 0 0 0 0 0 0 140 
140 0 0 0 0 140 140 140 140 140 140 0 0 0 0 140 
140 0 0 0 0 0 140 140 140 140 0 0 0 0 0 140 
140 141 0 0 0 0 0 0 0 0 0 0 0 0 141 140 
140 0 141 0 0 0 0 0 0 0 0 0 0 141 0 140 
140 0 0 141 0 0 0 0 0 0 0 0 141 0 0 140 
140 0 0 0 141 0 0 0 0 0 0 141 0 0 0 140 
140 0 0 0 0 0 0 0 0 0 0 0 0 0 0 140 
140 0 0 0 0 0 0 0 0 0 0 0 0 0 0 140 
140 0 0 0 0 0 0 141 141 0 0 0 0 0 0 140 
140 0 140 0 140 0 0 0 0 0 0 140 0 140 0 140 
140 0 140 0 0 0 0 0 0 0 0 0 0 140 0 140 
140 0 140 0 0 0 0 145 145 0 0 0 0 140 0 140 
140 0 140 0 0 0 0 146 146 0 0 0 0 140 0 140 
140 0 140 0 140 0 140 143 143 140 0 140 0 140 0 140 
140 140 140 0 0 0 0 143 143 0 0 0 0 140 140 140 
140 0 0 0 0 0 0 143 143 0 0 0 0 0 0 140 
140 0 0 0 0 140 140 142 142 140 0 0 0 140 0 140 
140 0 0 0 0 0 0 0 0 0 0 0 0 0 0 140 
140 0 0 140 0 0 0 0 0 0 0 140 0 140 0 140 
140 0 0 0 0 0 0 0 0 140 0 0 0 0 0 140 
140 0 140 0 140 0 140 0 140 0 0 0 0 0 0 140 
140 0 140 0 140 0 140 0 140 0 0 0 0 0 0 140 
140 140 140 140 140 140 140 140 140 140 140 0 0 0 0 140 
140 0 0 0 0 0 0 0 0 0 0 0 0 0 0 140 
140 0 0 0 0 0 0 0 0 0 0 0 0 0 0 140 
140 0 0 0 0 0 0 0 0 0 0 0 144 0 0 140 
140 0 0 0 0 0 0 0 0 0 144 0 143 0 0 140 
140 0 0 0 0 0 0 0 144 0 143 0 143 0 0 140 
140 0 0 0 0 0 0 0 143 0 143 0 143 0 0 140 
140 140 140 140 0 0 144 0 143 0 143 0 143 0 0 140 
140 0 0 0 0 0 143 0 143 0 143 0 143 0 0 140 
140 0 0 0 0 0 143 0 143 0 143 0 143 0 0 140 
140 0 0 0 145 0 143 0 143 0 143 0 143 0 0 140 
140 0 0 0 146 0 143 0 143 0 143 0 143 0 0 140 
140 121 0 0 142 0 142 0 142 0 142 0 142 0 0 140 
140 140 140 140 140 140 140 140 140 140 140 140 140 140 140 140 
#Entities#
R4(135,2020) R1(167,2115) R1(224,2115) R1(284,2115) R1(347,2115) R1(416,2115) R1(47,1725) R0(352,1755) R0(49,1933) R0(48,1997) 
R1(106,1725) R1(168,1725) R1(226,1725) R0(405,1330) R0(77,1332) R4(226,1390) R4(254,1390) R0(403,1150) R0(312,1245) R0(373,1181) 
R0(343,1209) R4(241,760) R1(199,675) R1(287,675) R3(436,675) R3(45,675) R0(427,274) R0(429,163) R0(427,232) R1(80,75) 
R0(168,406) R0(258,468) R2(49,225) R3(136,165) R3(375,495) R3(49,585) R4(433,395) R3(436,1485) R3(46,1485) R0(249,319) 
R3(284,1545) R3(199,1545) R0(348,338) R0(112,73) R0(280,882) R0(175,1002) R0(371,944) R0(115,943) R0(79,1152) R0(113,1180) 
R0(144,1209) R0(173,1242) 