66
14
0 0 0 0 0 0 0 0 0 0 0 0 0 0 0 0 0 0 0 0 0 0 0 0 0 0 0 0 0 0 0 0 0 0 0 0 0 0 0 0 0 0 0 0 0 0 0 0 0 0 0 0 0 0 0 0 0 0 0 0 0 0 0 0 0 0 
0 0 0 0 0 0 0 0 0 0 0 0 0 0 0 0 0 0 0 0 0 0 0 0 0 0 0 0 0 0 0 0 0 0 0 0 0 0 0 0 0 0 0 0 0 0 0 0 0 0 0 0 0 0 0 0 0 0 0 0 0 0 0 0 0 0 
0 0 0 0 0 0 0 0 0 0 0 0 0 0 0 0 0 0 0 0 0 0 0 0 0 0 0 0 0 0 0 0 0 0 0 0 0 0 0 0 0 0 0 0 0 0 0 0 0 0 0 0 0 0 0 0 0 0 0 0 0 0 0 0 0 0 
0 0 0 0 0 0 0 0 0 0 0 0 0 0 0 0 0 0 0 0 0 0 0 0 0 0 0 0 0 0 0 0 0 0 0 0 0 0 0 0 0 0 0 0 0 0 0 0 0 0 0 0 0 0 0 0 0 0 0 0 0 0 0 0 0 0 
0 0 0 0 0 0 0 0 0 0 0 0 0 0 0 0 0 0 0 0 0 0 0 0 0 0 0 0 0 0 0 0 0 0 0 0 0 0 0 0 0 0 0 0 0 0 0 0 0 0 0 0 0 0 0 0 0 0 0 0 0 0 0 0 0 0 
0 0 0 0 0 0 0 0 0 0 0 0 0 0 0 0 0 0 0 0 0 0 0 101 101 101 101 101 101 0 0 0 0 0 0 0 0 0 0 0 0 0 0 0 0 0 0 0 0 0 0 0 0 0 0 0 0 0 0 0 0 0 0 0 0 0 
0 0 0 0 0 0 0 0 0 0 0 0 0 0 0 0 0 0 0 0 0 0 0 0 0 0 0 0 0 0 0 0 0 0 0 0 0 0 0 0 0 0 0 0 84 0 0 0 0 0 0 0 0 0 0 0 0 0 0 0 0 0 0 0 0 0 
0 0 0 0 0 0 0 0 100 0 0 102 0 0 102 0 0 102 0 0 0 0 0 0 0 0 0 0 0 0 0 100 0 0 0 0 0 0 0 0 0 100 100 100 100 100 100 100 0 0 0 0 103 101 0 0 0 0 0 0 0 0 0 0 0 0 
0 0 0 0 0 0 0 100 101 0 0 0 0 0 0 0 0 0 0 0 0 0 0 0 0 0 0 0 83 0 83 0 0 102 0 0 0 0 0 100 0 0 0 0 0 101 101 101 0 0 103 0 103 101 0 0 0 0 0 0 0 0 0 0 0 0 
1 0 0 0 0 0 100 101 101 0 0 0 0 0 0 0 0 0 0 0 84 0 0 84 0 103 0 0 100 100 100 100 100 100 0 0 0 100 0 0 0 0 0 0 0 101 101 101 0 0 0 0 103 101 0 0 0 0 0 0 0 0 0 0 0 0 
0 84 0 0 0 100 101 101 101 0 0 0 84 84 0 84 84 0 0 100 100 100 100 100 0 103 0 0 0 0 0 0 0 0 0 100 83 0 83 0 83 0 83 0 0 101 101 101 0 84 0 0 103 101 82 0 0 0 0 0 0 0 0 0 0 0 
100 100 100 100 100 101 101 101 101 0 0 0 100 100 0 100 100 0 0 101 101 101 101 101 100 100 100 100 100 100 100 100 100 100 100 101 100 100 100 100 100 100 100 100 100 101 101 101 100 100 100 100 100 101 102 0 0 0 0 0 0 0 0 0 0 0 
101 101 101 101 101 101 101 101 101 0 0 0 101 101 0 101 101 0 0 101 101 101 101 101 101 101 101 101 101 101 101 101 101 101 101 101 101 101 101 101 101 101 101 101 101 101 101 101 101 101 101 101 101 101 0 0 0 0 0 0 0 0 0 0 0 0 
101 101 101 101 101 101 101 101 101 0 0 0 101 101 0 101 101 0 0 101 101 101 101 101 101 101 101 101 101 101 101 101 101 101 101 101 101 101 101 101 101 101 101 101 101 101 101 101 101 101 101 101 101 101 0 0 0 0 0 0 0 0 0 0 0 0 
#Entities#
R3(479,315) R3(392,315) R1(87,315) R0(649,283) R2(924,315) R4(999,313) R2(824,315) R2(877,315) R0(946,189) R0(763,215) 
R4(1272,313) R4(1423,193) R3(1160,315) R1(1308,195) R0(1360,191) R0(1269,189) R0(1065,241) R2(393,315) R2(482,315) R4(596,168) 
R0(963,311) R0(898,312) R0(858,313) R1(938,315) R2(883,255) R2(918,255) R2(957,255) R1(402,315) R1(493,315) R0(482,314) 
R0(383,316) R2(670,285) R2(607,287) R3(732,315) R3(799,315) R3(1037,315) R3(941,255) R3(898,255) 