16
100
140 140 140 140 140 140 140 140 140 140 140 140 140 140 140 140 
140 0 0 0 0 0 0 0 0 0 0 0 0 0 0 140 
140 122 0 0 0 0 0 0 0 0 0 0 0 0 0 140 
140 140 140 140 0 0 0 0 0 0 0 0 0 0 0 140 
140 0 0 0 0 0 0 0 0 0 0 0 0 0 0 140 
140 0 0 0 0 0 0 0 0 0 0 0 0 0 0 140 
140 0 0 0 0 0 0 0 0 0 0 0 0 0 0 140 
140 0 0 0 0 0 0 0 0 0 0 0 0 0 0 140 
140 0 0 0 0 0 0 0 0 0 0 0 0 0 0 140 
140 0 0 0 0 0 0 0 0 0 0 0 0 0 0 140 
140 0 0 0 0 0 0 0 0 0 0 0 0 0 0 140 
140 0 0 0 0 0 0 0 0 0 0 0 0 0 0 140 
140 0 0 0 0 0 0 0 0 0 0 0 0 0 0 140 
140 0 0 0 0 0 0 0 0 0 0 0 0 0 0 140 
140 0 0 0 0 0 0 0 0 0 0 0 0 0 0 140 
140 0 0 0 0 0 0 0 0 0 0 0 0 0 0 140 
140 0 0 0 0 0 0 0 0 0 0 0 0 0 0 140 
140 0 0 0 0 0 0 0 0 0 0 0 0 0 0 140 
140 0 0 0 0 0 0 0 0 0 0 0 0 0 0 140 
140 0 0 0 0 0 0 0 0 0 0 0 0 0 0 140 
140 0 0 0 0 0 0 0 0 0 0 0 0 0 0 140 
140 0 0 0 0 0 0 0 0 0 0 0 0 0 0 140 
140 0 0 0 0 0 0 0 0 0 0 0 0 0 0 140 
140 0 0 0 0 0 0 0 0 0 0 0 0 0 0 140 
140 0 0 0 0 0 0 0 0 0 0 0 0 0 0 140 
140 0 0 0 0 0 0 0 0 0 0 0 0 0 0 140 
140 0 0 0 0 0 0 0 0 0 0 0 0 0 0 140 
140 0 0 0 0 0 0 0 0 0 0 0 0 0 0 140 
140 0 0 0 0 0 0 0 0 0 0 0 0 0 0 140 
140 0 0 0 0 0 0 0 0 0 0 0 0 0 0 140 
140 0 0 0 0 0 0 0 0 0 0 0 0 0 0 140 
140 0 0 0 0 0 0 0 0 0 0 0 0 0 0 140 
140 0 0 0 0 0 0 0 0 0 0 0 0 0 0 140 
140 0 0 0 0 0 0 0 0 0 0 0 0 0 0 140 
140 0 0 0 0 0 0 0 0 0 0 0 0 0 0 140 
140 0 0 0 0 0 0 0 0 0 0 0 0 0 0 140 
140 0 0 0 0 0 0 0 0 0 0 0 0 0 0 140 
140 0 0 0 0 0 0 0 0 0 0 0 0 0 0 140 
140 0 0 0 0 0 0 0 0 0 0 0 0 0 0 140 
140 0 0 0 0 0 0 0 0 0 0 0 0 0 0 140 
140 0 0 0 0 0 0 0 0 0 0 0 0 0 0 140 
140 0 0 0 0 0 0 0 0 0 0 0 0 0 0 140 
140 0 0 0 0 0 0 0 0 0 0 0 0 0 0 140 
140 0 0 0 0 0 0 0 0 0 0 0 0 0 0 140 
140 0 0 0 0 0 0 0 0 0 0 0 0 0 0 140 
140 0 0 0 0 0 0 0 0 0 0 0 0 0 0 140 
140 0 0 0 0 0 0 0 0 0 0 0 0 0 0 140 
140 0 0 0 0 0 0 0 0 0 0 0 0 0 0 140 
140 0 0 0 0 0 0 0 0 0 0 0 0 0 0 140 
140 0 0 0 0 0 0 0 0 0 0 0 0 0 0 140 
140 0 0 0 0 0 0 0 0 0 0 0 0 0 0 140 
140 0 0 0 0 0 0 0 0 0 0 0 0 0 0 140 
140 0 0 0 0 0 0 0 0 0 0 0 0 0 0 140 
140 0 0 0 0 0 0 0 0 0 0 0 0 0 0 140 
140 0 0 0 0 0 0 0 0 0 0 0 0 0 0 140 
140 0 0 0 0 0 0 0 0 0 0 0 0 0 0 140 
140 0 0 0 0 0 0 0 0 0 0 0 0 0 0 140 
140 0 0 0 0 0 0 0 0 0 0 0 0 0 0 140 
140 0 0 0 0 0 0 0 0 0 0 0 0 0 0 140 
140 0 0 0 0 0 0 0 0 0 0 0 0 0 0 140 
140 0 0 0 0 0 0 0 0 0 0 0 0 0 0 140 
140 0 0 0 0 0 0 0 0 0 0 0 0 0 0 140 
140 0 0 0 0 0 0 0 0 0 0 0 0 0 0 140 
140 0 0 0 0 0 0 0 0 0 0 0 0 0 0 140 
140 0 0 0 0 0 0 0 0 0 0 0 0 0 0 140 
140 0 0 0 0 0 0 0 0 0 0 0 0 0 0 140 
140 0 0 0 0 0 0 0 0 0 0 0 0 0 0 140 
140 0 0 0 0 0 0 0 0 0 0 0 0 0 0 140 
140 0 0 0 0 0 0 0 0 0 0 0 0 0 0 140 
140 0 0 0 0 0 0 0 0 0 0 0 0 0 0 140 
140 0 0 0 0 0 0 0 0 0 0 0 0 0 0 140 
140 0 0 0 0 0 0 0 0 0 0 0 0 0 0 140 
140 0 0 0 0 0 0 0 0 0 0 0 0 0 0 140 
140 0 0 0 0 0 0 0 0 0 0 0 0 0 0 140 
140 0 0 0 0 0 0 0 0 0 0 0 0 0 0 140 
140 0 0 0 0 0 0 0 0 0 0 0 0 0 0 140 
140 0 0 0 0 0 0 0 0 0 0 0 0 0 0 140 
140 0 0 0 0 0 0 0 0 0 0 0 0 0 0 140 
140 0 0 0 0 0 0 0 0 0 0 0 0 0 0 140 
140 0 0 0 0 0 0 0 0 0 0 0 0 0 0 140 
140 0 0 0 0 0 0 0 0 0 0 0 0 0 0 140 
140 0 0 0 0 0 0 0 0 0 0 0 0 0 0 140 
140 0 0 0 0 0 0 0 0 0 0 0 0 0 0 140 
140 0 0 0 0 0 0 0 0 0 0 0 0 0 0 140 
140 0 0 0 0 0 0 0 0 0 0 0 0 0 0 140 
140 0 0 0 0 0 0 0 0 0 0 0 0 0 0 140 
140 0 0 0 0 0 0 0 0 0 0 0 0 0 0 140 
140 0 0 0 0 0 0 0 0 0 0 0 0 0 0 140 
140 0 0 0 0 0 0 0 0 0 0 0 0 0 0 140 
140 0 0 0 0 0 0 0 0 0 0 0 144 0 0 140 
140 0 0 0 0 0 0 0 0 0 144 0 143 0 0 140 
140 0 0 0 0 0 0 0 144 0 143 0 143 0 0 140 
140 0 0 0 0 0 0 0 143 0 143 0 143 0 0 140 
140 0 0 0 0 0 144 0 143 0 143 0 143 0 0 140 
140 0 0 0 0 0 143 0 143 0 143 0 143 0 0 140 
140 0 0 0 0 0 143 0 143 0 143 0 143 0 0 140 
140 0 0 0 145 0 143 0 143 0 143 0 143 0 0 140 
140 0 0 0 146 0 143 0 143 0 143 0 143 0 0 140 
140 121 0 0 142 0 142 0 142 0 142 0 142 0 0 140 
140 140 140 140 140 140 140 140 140 140 140 140 140 140 140 140 
#Entities#
R4(135,2860) R1(167,2955) 