16
9
21 0 0 0 0 0 0 0 0 0 0 0 0 0 0 21 
21 0 0 0 0 0 0 0 0 0 0 22 0 0 0 21 
21 0 0 0 0 0 0 0 0 0 22 0 0 0 22 21 
21 0 0 0 0 0 0 0 0 22 22 22 22 22 22 21 
21 0 0 0 0 0 0 0 0 0 0 0 0 0 0 21 
21 0 0 0 0 0 0 0 22 0 0 0 0 0 0 21 
21 1 0 22 22 0 22 22 22 0 22 0 22 0 2 21 
21 21 20 20 20 20 20 20 20 20 20 20 20 20 20 21 
21 21 21 21 21 21 21 21 21 21 21 21 21 21 21 21 
