16
9
21 0 0 0 0 0 0 0 0 0 0 0 0 0 0 21 
21 0 0 0 0 0 0 0 0 0 0 0 0 0 0 21 
21 0 0 0 0 0 0 0 0 0 22 0 0 0 22 21 
21 0 0 0 0 0 0 0 0 22 22 22 22 22 22 21 
21 0 0 0 0 0 0 0 0 0 0 0 0 0 0 21 
21 0 0 0 0 0 0 0 22 0 0 0 0 0 0 21 
21 1 0 22 22 0 22 22 22 0 0 0 0 0 0 21 
21 21 20 20 20 20 20 20 20 20 20 20 20 20 20 21 
21 21 21 21 21 21 21 21 21 21 21 21 21 21 21 21 
#Entities#
R1(350,160) R1(250,100) R1(360,40)